0000000000000000000000000000000000000000
0000000000000000022220000000000000000000
0000000000000002211112000000000000000000
0000000000000021111111220000000000000220
0000000000000002111122000000000002222112
0000000000000021111200000000000021111110
0000000222000211111120000220000001111000
0000002111222111111112222112000000011000
0222000111111111111111111111200000010000
2111220001111111111111111000000000010000
0111100000111111111111100000000000000000
0011000000111111111100000000000000000000
0010000000011111100000000000000000000000
0010000000000111000000000000000000000000
0010000000000001000000000000000000000000
0000000000000001000000000000000000000000