0000000000000000000
0000000000000000000
0000000000000000222
0000000000002200000
0000000022000000000
0000220000000000000
2200000000000000022
1122222222222222211
1111111111111111111
1111111111111111111
1111111111111111111
1111111111111111111
1111111111111111111
1111111111111111111